{
  "name": "intro",
  "board": [
    [  1,  2,  2,  2,  2,  2,  2,  2,  2,  2,  2,  2,  2,  4],
    [  3, 14, 15, 14, 15, 14, 15, 15, 15, 14, 15, 15, 15,  8],
    [  3,  0,  0,  0,  0,  0,  0,  0,  0,  0,  0,  0,  0,  8],
    [  3,  0,  0,  0,  0,  0,  0,  0,  0,  0,  0,  0,  0,  8],
    [  3,  0,  0,  0,  0,  0,  0,  0,  0,  0,  0,  0,  0,  8],
    [  3,  0,  0,  0,  9,  9,  9,  9,  9,  9,  0,  0,  0,  8],
    [  3,  0,  0,  0,  9,  9,  9,  9,  9,  9,  0,  0,  0,  8],
    [  3,  0,  0,  0,  9,  9,  9,  9,  9,  9,  0,  0,  0,  8],
    [  3,  0,  0,  0,  9,  9,  9,  9,  9,  9,  0,  0,  0,  8],
    [  3,  0,  0,  0,  9,  9,  9,  9,  9,  9,  0,  0,  0,  8],
    [  3,  0,  0,  0,  9,  9,  9,  9,  9,  9,  0,  0,  0,  8],
    [  3,  0,  0,  0,  0,  0,  0,  0,  0,  0,  0,  0,  0,  8],
    [  3,  0,  0,  0,  0,  0,  0,  0,  0,  0,  0,  0,  0,  8],
    [  3,  0,  0,  0,  0,  0,  0,  0,  0,  0,  0,  0,  0,  8],
    [  6,  7,  7,  7,  7,  7,  7,  7,  7,  7,  7,  7,  7,  5]
    ],  
  "availableCharacters": [
		{ "name": "Pawn", "count": 5 },
		{ "name": "Knight", "count": 5 },
		{ "name": "Bishop", "count": 5 },
		{ "name": "Rook", "count": 5 },
		{ "name": "Queen", "count": 5 },
    { "name": "King", "count": 5 }
	],
  "trees": [
    { "x": 6, "y": 7 },
    { "x": 7, "y": 7 },
    { "x": 6, "y": 8 },
    { "x": 7, "y": 8 }
  ],
  "coins": [
    { "x": 4, "y": 6 },
    { "x": 9, "y": 9 },
    { "x": 7, "y": 5 }
  ],
  "enemies": [],
  "staritngPosition": { "x": 4, "y": 10 },
  "requiredPoints": 2,
  "exitPosition": { "x": 8, "y": 8 },
  "nextLevel": "level2",
  "forceGreatRoll": false
  }