{
    "name": "level2",
    "board": [
        [  1,  2,  2,  2,  2,  2,  2,  2,  2,  2,  2,  4],
        [  3, 14, 15, 14, 15, 14, 15, 14, 15, 14, 15,  8],
        [  3,  0,  0,  0,  0,  0,  0,  0,  0,  0,  0,  8],
        [  3,  0,  0,  0,  0,  0,  0,  0,  0,  0,  0,  8],
        [  3,  0,  0,  9,  9,  9,  9,  9,  9,  0,  0,  8],
        [  3,  0,  0,  9,  9,  9,  9,  9,  9,  0,  0,  8],
        [  3,  0,  0,  9,  9,  9,  9,  9,  9,  0,  0,  8],
        [  3,  0,  0,  9,  9,  9,  9,  9,  9,  0,  0,  8],
        [  3,  0,  0,  9,  9,  9,  9,  9,  9,  0,  0,  8],
        [  3,  0,  0,  9,  9,  9,  9,  9,  9,  0,  0,  8],
        [  3,  0,  0,  9,  9,  9,  9,  9,  9,  0,  0,  8],
        [  3,  0,  0,  9,  9,  9,  9,  9,  9,  0,  0,  8],
        [  3,  0,  0,  9,  9,  9,  9,  9,  9,  0,  0,  8],
        [  3,  0,  0,  9,  9,  9,  9,  9,  9,  0,  0,  8],
        [  3,  0,  0,  0,  0,  0,  0,  0,  0,  0,  0,  8],
        [  3,  0,  0,  0,  0,  0,  0,  0,  0,  0,  0,  8],
        [  6,  7,  7,  7,  7,  7,  7,  7,  7,  7,  7,  5]
      ],
      
    "availableDices": [0,1,2,4],
  "trees": [
    { "x": 5, "y": 6 },
    { "x": 6, "y": 6 },

    { "x": 3, "y": 9 },
    { "x": 4, "y": 9 },
    { "x": 7, "y": 9 },
    { "x": 8, "y": 9 },

    { "x": 5, "y": 11 },
    { "x": 6, "y": 11 },
    { "x": 5, "y": 12 },
    { "x": 6, "y": 12 }
  ],
  "coins": [
    { "x": 3, "y": 5 },
    { "x": 7, "y": 8 },
    { "x": 8, "y": 10 },
    { "x": 4, "y": 12 }
  ],
  "enemies": [
    {
        "type": "Bishop",
        "image": "patovicaalfil",
        "position": { "x": 3, "y": 8 }
      },
    {
      "type": "Bishop",
      "image": "patovicaalfil",
      "position": { "x": 8, "y": 12 }
    },
    {
        "type": "Bishop",
        "image": "patovicaalfil",
        "position": { "x": 8, "y": 6 }
      }
  ],
  "staritngPosition": { "x": 6, "y": 4 },
  "requiredPoints": 3,
  "exitPosition": { "x": 3, "y": 12 },
  "nextLevel": "tutorial"
  }