{
  "name": "reina",
  "board": [
    [ 11, 11,  1,  2,  2,  2,  2,  2,  2,  2,  2,  2,  4, 11, 11],
    [ 11,  1, 13, 14, 15, 14, 15, 14, 14, 15, 14, 15, 12,  4, 11],
    [  1, 13, 14,  0,  0,  0,  0,  0,  0,  0,  0,  0, 14, 12,  4],
    [  3, 15,  0,  0,  0,  0,  0,  0,  0,  0,  0,  0,  0, 15,  8],
    [  3,  0,  0,  0,  9,  9,  9,  9,  9,  9,  9,  0,  0,  0,  8],
    [  3,  0,  0,  9,  9,  9,  9,  9,  9,  9,  9,  9,  0,  0,  8],
    [  3,  0,  0,  9,  9,  9,  9,  9,  9,  9,  9,  9,  0,  0,  8],
    [  3,  0,  0,  9,  9,  9,  9,  9,  9,  9,  9,  9,  0,  0,  8],
    [  3,  0,  0,  9,  9,  9,  9,  9,  9,  9,  9,  9,  0,  0,  8],
    [  3,  0,  0,  9,  9,  9,  9,  9,  9,  9,  9,  9,  0,  0,  8],
    [  3,  0,  0,  0,  9,  9,  9,  9,  9,  9,  9,  0,  0,  0,  8],
    [  6, 16,  0,  0,  0,  0,  0,  0,  0,  0,  0,  0,  0, 17,  5],
    [ 11,  6, 16,  0,  0,  0,  0,  0,  0,  0,  0,  0, 17,  5, 11],
    [ 11, 11,  6,  7,  7,  7,  7,  7,  7,  7,  7,  7,  5, 11, 11]
    ],
  "availableDices": [0,1,3],
  "trees": [
  ],
  "coins": [
    { "x": 9, "y": 6 },
    { "x": 4, "y": 5 },
    { "x": 8, "y": 9 },
    { "x": 3, "y": 8 }
  ],
  "enemies": [
    {
        "type": "Queen",
        "image": "patovicareina",
        "position": { "x": 7, "y": 7 }
    }
  ],
  "staritngPosition": { "x": 5, "y": 4 },
  "requiredPoints": 2,
  "exitPosition": { "x": 8, "y": 4 },
  "nextLevel": "level2"
  }